                                                . ..,,,,,,,,,.  ........,,,,,,,,,,..                                                                                                                 
                                        .    .,,,..,,,.    ..,,,,,,,,,,,,,,,,,,,,,,,,                .,,,,..                                      ... ..                                             
                              ...... .   ,,   ... ...      .....,,,,,,,,,,,,,,,,,,,,.                                           ....             .....,,,,,,             ...                         
                            .,,,,.    ,  ., ... ,.,,...           ,,,,,,,,,,,,,,,. .                                        ..       .    .,,,,,,,,,,,,,,,,,,,,...,..      ..                        
        .,,,,,,,,...     ...     ..,,,,,,   .,   .....,,,,,       ..,,,,,,,,,,,,,..                      ..,,,,,.               .  .,,.,,,,,,,,,,,,,,,,,,,,,,,,,,,,,,,,,,,,,,,,,,,,,,.     ...       
        .,,,,,,,,,,,,,,,,,,,,,,,,,,,,,,,,,,,,,,,,,,.    .,,,,,    .,,,,,,,,,,.                         .,,,,,,,,,,,,,. ,.,,,,,,,,,,,,,.,,,,,,,,,,,,,,,,,,,,,,,,,,,,,,,,,,,,,,,,,,,,,,,,,,,,,,,,,,,,..
         ,,,,,,,,,,,,,,,,,,,,,,,,,,,,,,,,,,,,,,. ...  .  ,,,.       .,,,,,          ...             .,,,,,. ,,,,,,,.,,,,,,,,,,,,,,,,,,,,,,,,,,,,,,,,,,,,,,,,,,,,,,,,,,,,,,,,,,,,,,,,,,,,,,,,,,,.     
       .,,,,,,., ,,,,,,,,,,,,,,,,,,,,,,,,,,,,         ,,,,.           .,.                          ,,,,,,  ,,,,,,,,,,,,,,,,,,,,,,,,,,,,,,,,,,,,,,,,,,,,,,,,,,,,,,,,,,,,,,,,,,,,,,,,   .,,.,.         
           ,..          ,,,,,,,,,,,,,,,,,,,,,,        .,,,,,,,                               ,.       ,,   ..,,,,,,,,,,,,,,,,,,,,,,,,,,,,,,,,,,,,,,,,,,,,,,,,,,,,,,,,,,,,,.         ,,.              
        .                .,,,,,,,,,,,,,,,,,,,,,,,,,  ,,,,,,,,,,,                           ,..,     ,.. ..,,,,,,,,,,,,,,,,,,,,,,,,,,,,,,,,,,,,,,,,,,,,,,,,,,,,,,,,,,,,,,,          ,,,               
                           .,,,,,,,,,,,,,,,,,,,,,,,,,,,,,,,,,,,,..                           ....,,,,,,,,,,,,,,,,,,,,,,,,,,,,,,,,,,,,,,,,,,,,,,,,,,,,,,,,,,,,,,,,,,,,,,,,,, .      .                 
                             .,,,,,,,,,,,,,,,,,.  ,,,,,,,,,,.   ,,.                          .,,,,,,,,,,,,,,,,,,,,,,,,,,,,,,,,,,,,,,,,,,,,,,,,,,,,,,,,,,,,,,,,,,,,,,,,,,,,.                          
                             ,,,,,,,,,,,,,,,,,,,,.,.,,,,,,,...                                 ,,,,,,, .,,,,,,,.    ,,,,,  ,,,, ,,,,,,,,,,,,,,,,,,,,,,,,,,,,,,,,,,,,,,,,.  ..                        
                             ,,,,,,,,,,,,,,,,,,,,,, .,,,,.                                 ,,,,,,   . ,,  ,,,,.  ..   ,,,.  .,,,,,,,,,,,,,,,,,,,,,,,,,,,,,,,,,,,,,,,,                                
                             .,,,,,,,,,,,,,,,,,,,,,,,,.                                    ,,,,.          .,  ,,,,,,,,,,,,  .,,,,,,,,,,,,,,,,,,,,,,,,,,,,,,,,,,    ,      ..                         
                              .,,,,,,,,,,,,,,,,,,,,,,,,                                     .  .,,,,,.             ,,,,,,,,,,,,,,,,,,,,,,,,,,,,,,,,,,,,,,,,,,,,.   ,,  ..,,                          
                                 ,,,,,,,,,,,,,,,,,,,,                                      ,,,,,,,,,,,..  ..      ,,,,,,,,,,,,,,,,,,,,,,,,,,,,,,,,,,,,,,,,,,,,,,.    ,.                              
                                  ..,,,,,,,,,...   ,                                      ,,,,,,,,,,,,,,,,,,,,,,,,,,,,,,, .,,,,,,,,,,,,,,,,,,,,,,,,,,,,,,,,,,,,,,                                    
                                   . ,,,,,,        ..                                   ,,,,,,,,,,,,,,,,,,,,,,,,,, ,,,,,,,. ..,,,,,,,,,,,,,,,,,,,,,,,,,,,,,,,,,,                                     
                                    . .,,,,                                            ,,,,,,,,,,,,,,,,,,,,,,,,,,,. ,,,,,,,,,,,     .,,,,,,,,,,,,,,,,,,,,,,,,,  .                                    
                                       ,,,,.   ,,     ..                               ,,,,,,,,,,,,,,,,,,,,,,,,,,,,. ,,,,,,,,,,        ,,,,,,,   .,,,,,,. .                                          
                                         .,,,,,,.                                      ,,,,,,,,,,,,,,,,,,,,,,,,,,,,,. ,,,,,,,          ,,,,,      ,,,,,,,       ,                                    
                                              .,,,,                                   .,,,,,,,,,,,,,,,,,,,,,,,,,,,,,,,.,,.             .,,          ,,,,,,      .                                    
                                                 .,     ,.,                            ,,,,,,,,,,,,,,,,,,,,,,,,,,,,,,,,  .,             .,          .  ,,,       ..                                  
                                                   ...,,,,,,,,,.                         ,,,,,,,,,,,,,,,,,,,,,,,,,,,,,,,,,.               ,         ..           .,                                  
                                                      ,,,,,,,,,,,,,.                       ,...    ,,,,,,,,,,,,,,,,,,,,,,                         .. .,      .,                                      
                                                     .,,,,,,,,,,,,,,.                                ,,,,,,,,,,,,,,,,,,.                            ,,..   ,,,.                                      
                                                    .,,,,,,,,,,,,,,,...                             ,,,,,,,,,,,,,,,,,,                               .,.  ,,,, ..    .,                              
                                                    ,,,,,,,,,,,,,,,,,,,,,,,                          .,,,,,,,,,,,,,,,                                 .,     . ..      .,,,,,                        
                                                     ,,,,,,,,,,,,,,,,,,,,,,,,                         ,,,,,,,,,,,,,,.                                   .,.,.            .,,,,.                      
                                                      ,,,,,,,,,,,,,,,,,,,,,,                           ,,,,,,,,,,,,,,.                                                                               
                                                       ,,,,,,,,,,,,,,,,,,,.                           ,,,,,,,,,,,,,,,.   ,.                                        . ,,,.  ,.                        
                                                         ,,,,,,,,,,,,,,,,,.                           ,,,,,,,,,,,,,,.  ,,,                                       ,,,,,,,,. ,,.                       
                                                          ,,,,,,,,,,,,,,,,                            .,,,,,,,,,,,     ,,.                                     .,,,,,,,,,,,,,,,                      
                                                          ,,,,,,,,,,,,,,.                              .,,,,,,,,,,.    ,,                                   .,,,,,,,,,,,,,,,,,,,.                    
                                                         .,,,,,,,,,,,.                                 .,,,,,,,,,                                           .,,,,,,,,,,,,,,,,,,,,.                   
                                                         ,,,,,,,,,,,,                                   .,,,,,,,.                                            ,,,,,,,,,,,,,,,,,,,,.                   
                                                         ,,,,,,,,,,.                                     .,,,,,                                               ,,,,,.  .,,,,,,,,,,                    
                                                         ,,,,,,,.                                                                                                        .,,,,,,            .        
                                                        .,,,,,,,.                                                                                                          .,,.              ,,      
                                                        .,,,..                                                                                                               .,             ..       
                                                       ..,,,                                                                                                                             .,.         
                                                       .,,,,                                                                                                                                         
                                                       .,,,                                                                                                                                          
                                                         .,                                                                                                                                          
                                                                                                                                                                                                     
                                                                                                                                                                                                     
                                                                                                                                                                                                     
